20 10
####################
#///////#//////////#
#//H//////////M////#
#########//////////#
#MMM///////////////#
#//////////#//######
#///#M######/M/////#
#///#//////#///E///#
#///#//////#/////M/#
####################
