40 8
########################################
#/H////#/M////////////#//////////M/////#
#//////#//////////////#////////////////#
###/####///////M//////#/M/////////////##
#/////////////////////#####/#########M##
#////////////////////////////////##///M#
#///M/////////////////M//////////##/E//#
########################################
