26 12
##########################
#H/#//////////////////M//#
##/#//M//////////////////#
#////################/####
######/////M/////#/////M/#
#M///#M///////////M//////#
#///M////////////#/////M/#
#M///#####################
###/##/////////////////M/#
#/////M################/##
#//////////////########/E#
##########################
