25 10
#########################
#H//################///M#
#//////////////////M////#
#//M#######/########////#
#####/////M/#############
#####M/////////////////M#
######################//#
#///#//M#///#///#///#///#
#E//M/#///#///#///#M//###
#########################
