20 20
####################
#/////////////######
#////#////////######
#H///###///////#####
##########//////####
#############//////#
#/////////M////////#
#M/////M////////M//#
#////###############
#////###############
##////////////////##
##/////M////M/////##
########////########
########////########
#//////////////////#
#//M////////////M//#
###/#####MM#####/###
#/////#//////#/////#
#/////#E/////#/////#
####################
