10 14
##########
#/H/######
#////////#
######/M/#
#////////#
###////###
#//M//M//#
##M/##//##
###////###
###//M/###
#M//######
#////M///#
######//E#
##########
