14 19
##############
##/////////M##
##//##//##//##
##//#////#//##
##/M#/H//#//##
##//######//##
##//////////##
####M////M####
##////##////##
##////##////##
####//////####
##/M//////M/##
##//##//##//##
##//#///M#//##
##//######//##
##//////////##
######//######
####////ME####
##############
