16 13
################
#///////H//M///#
###M/######//###
#//////##//////#
###//######M/###
#//M///##//////#
#//////##/////M#
###/M######//###
#//////##//M///#
###/#####//#####
#//M//#//M////M#
#//E//#M/////M/#
################
