19 22
###################
#/////////////////#
#//######/######//#
#//######H######//#
#M//###########//M#
###/////////////###
##///####/####///##
#//####//M//####//#
#//##///###///##//#
#//##//M///M//##//#
#//####//////###//#
#M////########///M#
####///////////####
###/////#M#/////###
#////////#////////#
#M/##///M#M///##/M#
#////////#////////#
###/////#M#//////##
#####/////////#####
###M//#######//M###
#####///MEM///#####
###################
